21 21 11
.....................
.####################
.#..#.#...........##.
.##.#...##.######....
.#..#####......#.###.
.#.#......#.##.#.....
.#.#.####.#....#.#.##
.#...#....#.##.#.#..#
.#.#...#.##....#...##
.#.#####..#.##.#.#..#
.#.#...#.#.....#.##.#
.#.#.#.#.##.####.##.#
.#.#.#.#.#.....#.##.#
.#.#......###.#..##..
.#.#.######.#.#.#.#.#
.#............#.....#
.#.####.#####.#.###.#
.#............#.....#
.#.#######.##.#######
.....................
.###################.
