19 19 8
####..####..#..####
...#..#.....#......
...#..#.....#......
#..#..#..####..####
#.................#
#.................#
#..####..#..####..#
......#..#.........
......#..#.........
####..#..#..#..#..#
............#..#..#
............#..#..#
#..####..#..#..#..#
#........#.........
#........#.........
#..#..#..#..####..#
...#..#..#........#
...#..#..#........#
####..#..#..####..#
