21 21 20
.....................
..#...#...#...#...#..
....#...#...#...#....
...#..#...#...#..#...
.....#..#...#..#.....
..#.#..#..#..#..#.#..
......#.......#......
...#.#..#.#.#..#.#...
.....................
#........#.#........#
.....................
..#.#.#.#...#.#.#.#..
.....................
...#.#..#.#.#..#.#...
......#.......#......
..#.#..#..#..#..#.#..
.....#..#...#..#.....
...#..#...#...#..#...
....#...#...#...#....
..#...#...#...#...#..
.....................
